SO /Users/hed-dyb/Desktop/the_cube/texturs_and_maps/n.xpm


       F     10  ,    100 ,    100       
C    0     ,     0    , 255


       SO /Users/hed-dyb/Desktop/the_cube/texturs_and_maps/s.xpm        
         WE /Users/hed-dyb/Desktop/the_cube/texturs_and_maps/w.xpm
       EA /Users/hed-dyb/Desktop/the_cube/texturs_and_maps/e.xpm




111111
100101
101001
1100N1
111111
