SO /Users/hed-dyb/Desktop/the_cube/texturs/s.xpm
WE /Users/hed-dyb/Desktop/the_cube/texturs/s.xpm       
NO /Users/hed-dyb/Desktop/the_cube/texturs/s.xpm
EA /Users/hed-dyb/Desktop/the_cube/texturs/s.xpm

F     55,55 ,55       
C    55,55, 55







     11111111111111111111111111111111
     10000000001100000000000010011111
     101100000111000000000000111101111
     1001000000000000000000001111111111
111111111011000001110000000000001
100000000011000001110111111111111
11110111111111011100000010001
11110111111111011101010010001
11000000110101011100000010001
10000000000000001100000010001
10000000000000001101010010001
110000011101010111110111100111111111   1
11110111 1110101 101111010001 1111111
1111100010000000100111111111011011
1000000000110000000000001111011011
1011000001110000000000001111011011
1001000000000000000000001111011011
111111111011000001110000000000001
100000000011000001110111111111111
11110111111111011100000010001
11110111111111011101010010001
11000000110101011100000010001
10000000000000001100000010001
10000000000000001101010010001
110000011101010111110111100111
11110111 1111101 1011110100011111111   111111
111110001001  101000111111111011011
1000000000111100000000001111011011
1011000001110000000000001111011011
1001000000000000000000001111011011
111111111011000001110000000000001
100000000011000001110111111111111
11110111111111011100000010001
11110111111111011101010010001
11000000110101011100N000010001
10000000000000001100000010001
10000000000000001101010010001
110000011101010111110111100111
11110111 1110101 101111010001111111111111  1111111
111111111111000010000001111111111
1000000000110000000000001111011011
1011000001110000000000001111011011
100100000000000000000000111011011
111111111011000001110000000000001
100000000011000001110111111111111
11110111111111011100000010001
11110111111111011101010010001
11000000110101011100000010001
10000000000000001100000010001
10000000000000001101010010001
110000011101010111110111100111
11110111 1110101 101111010001111111111
1111111111111111111111 11111111