






###1111111####
##100110001###
#1000100001###
100000000001##
#10000N000001#
##100000000001
##111111111111
