NO /Users/hed-dyb/Desktop/the_cube/texturs_and_maps/n.xpm


       F     10  ,    100 ,    100       
C    0     ,     0    , 255


       SO /Users/hed-dyb/Desktop/the_cube/texturs_and_maps/s.xpm        
         WE /Users/hed-dyb/Desktop/the_cube/texturs_and_maps/w.xpm
       EA /Users/hed-dyb/Desktop/the_cube/texturs_and_maps/e.xpm










     1111111111111111111111111111
    10000000001100000000000001111
    10110000011100000000000000001
    100010000000000000000000111111
 1111111111011000001110000000000001 1
10000000001100000111011111111111011
11110111111111011100000010001  1111
11110111111111011101010010001
1100000011110101 100000010001
1000000001 10000110000010001
10000000011100001101010000001
11000001110101N0111101111000111
11110111 1110101  101111010001
11111111 1111111  111111111111
11111111111  111   1111111111111
11111111111





