F 0,255,0


NO       textures/N.xpm
SO textures/S.xpm
EA textures/E.xpm

C 0,0,255
WE     textures/W.xpm


1111111111111111111111111111111111111111111111111111111
10000000000000000000000000000000000000000000000000000000001
1111111111111111111111111111111111111111111111111111111
