F 0,255,0


NO       textures/N.xpm
SO textures/S.xpm
EA textures/E.xpm

C 0,               0        ,255
WE     textures/W.xpm


111111
100101
101001
1100N1
111111