F 0,255,0


NO       textures/N.xpm
SO textures/S.xpm
EA textures/E.xpm

C 0,0,255
WE     textures/W.xpm








111111111111111111
100000000000000001
100000000000000001
1000000N0000000001
100000000000000001
100000000000000001
111111111111111111


